%%%%%%%%%%%
%%%.......%
%%......%.%
%P........%
%%%%%%%%%%%