%%%%%%%%%%%
%%%       %
%%      % %
%P        %
%%%%%%%%%%%