%%%%%%%%%%%%%%
%%%%%%....%%%%
%%%%%%....%%%%
%%%%...%%.%%%%
%......%.....%
%.%........%.%
%.%%..P.%%...%
%....%%%%%...%
%%%%%%%%%%%%%%