%%%%%%%%%%%%%%
%%%%%%    %%%%
%%%%%%    %%%%
%%%%   %% %%%%
%      %     %
% %        % %
% %%  P %%   %
%    %%%%%   %
%%%%%%%%%%%%%%