%%%%%%%
%   oP%
% %%%o%
%  %  %
%%   %%
%. %%%%
%%%%%%%
